
#mytestgroup = {
#	1 2 3
#}
confederacy_group = {
    883 884 885 886 887 888 893 894 895 897 918 919 920 921 922 923 924 925 926 927 928 929 930
    931 932 933 934 935 936 937 938 939 949 950 952 2011 2014 2497 2498 2499 2500 2515 2516 2527
    2528 2529 2530 2531 2532 2533 2534 2535 2536 2537 2538 2539 2540 2541 2542 2543 2544 2545 2546
    2547 2548 2549 2550 2552 2665 2666 2669 4625 4626 4627 4628 4629 4877 4878 4879 4880 4881 4882
    4883 4884 4885 4886 4909 4910 4911 4913 4923
}